NO ./assets/brick-wall.xpm
SO ./assets/dungeon-light.xpm
WE ./assets/broken-wall.xpm
EA ./assets/stone-wall.xpm

F 125,78,38
C 40,40,40

        1111111111111111111111111
111111111000000000110000000111111
        1001000000000000000000001
        1001000000000000000000001
111111111000000000000000000000001
100000000000000000000111111111111
11110000000000000000000000001
11110000000000000000000000001
11000000110000000000000000001
10000000000000000ooo000cc0001
10000000000000000000000000001
11111111100000000110000000111111
111111111000000000110000000111111
        1001000000000000000000001
        1001000000000000000000001
111111111000000000000000000000001
100000000000000000000111111111111
11110000000000000000000000001
11110000000000000000000000001
11000000110000000000000000001
10000000000000000ooo000cc0001
10000000000000000000000000001
11111111100000000110000000111111
111111111000000000110000000111111
        1001000000000000000000001
        1001000000000000000000001
111111111000000000000000000000001
100000000000000000000111111111111
11110000000000000000000000001
11110000000000000000000000001
11000000110000000000000000001
10000000000000000ooo000cc0001
10000000000000000000000000001
11111111100000000110000000111111
111111111000000000110000000111111
        1001000000000000000000001
        1001000000000000000000001
111111111000000000000000000000001
100000000000000000000111111111111
11110000000000000000000000001
11110000000000000000000000001
11000000110000000000000000001
10000000000000000ooo000cc0001
10000000000000000000000000001
11111111100000000110000000111111
111111111000000000110000000111111
        1001000000000000000000001
        1001000000000000000000001
111111111000000000000000000000001
100000000000000000000111111111111
11110000000000000000000000001
11110000000000000000000000001
11000000110000000000000000001
10000000000000000ooo000cc0001
10000000000000000000000000001
1111111110000N000110000000111111
111111111000000000110000000111111
        1001000000000000000000001
        1001000000000000000000001
111111111000000000000000000000001
100000000000000000000111111111111
11110000000000000000000000001
11110000000000000000000000001
11000000110000000000000000001
10000000000000000ooo000cc0001
10000000000000000000000000001
11111111100000000110000000111111
111111111000000000110000000111111
        1001000000000000000000001
        1001000000000000000000001
111111111000000000000000000000001
100000000000000000000111111111111
11110000000000000000000000001
11110000000000000000000000001
11000000110000000000000000001
10000000000000000ooo000cc0001
10000000000000000000000000001
11111111100000000110000000111111
111111111000000000110000000111111
        1001000000000000000000001
        1001000000000000000000001
111111111000000000000000000000001
100000000000000000000111111111111
11110000000000000000000000001
11110000000000000000000000001
11000000110000000000000000001
10000000000000000ooo000cc0001
10000000000000000000000000001
11111111100000000110000000111111
111111111000000000110000000111111
        1001000000000000000000001
        1001000000000000000000001
111111111000000000000000000000001
100000000000000000000111111111111
11110000000000000000000000001
11110000000000000000000000001
11000000110000000000000000001
10000000000000000ooo000cc0001
10000000000000000000000000001
11111111100000000110000000111111
111111111000000000110000000111111
        1001000000000000000000001
        1001000000000000000000001
111111111000000000000000000000001
100000000000000000000111111111111
11110000000000000000000000001
11110000000000000000000000001
11000000110000000000000000001
10000000000000000ooo000cc0001
10000000000000000000000000001
11111111100000000110000000111111
111111111000000000110000000111111
        1001000000000000000000001
        1001000000000000000000001
111111111000000000000000000000001
100000000000000000000111111111111
11110000000000000000000000001
11110000000000000000000000001
11000000110000000000000000001
10000000000000000ooo000cc0001
10000000000000000000000000001
11111111100000000110000000111111
111111111000000000110000000111111
        1001000000000000000000001
        1001000000000000000000001
111111111000000000000000000000001
100000000000000000000111111111111
11110000000000000000000000001
11110000000000000000000000001
11000000110000000000000000001
10000000000000000ooo000cc0001
10000000000000000000000000001
11111111100000000110000000111111
111111111000000000110000000111111
        1001000000000000000000001
        1001000000000000000000001
111111111000000000000000000000001
100000000000000000000111111111111
11110000000000000000000000001
11110000000000000000000000001
11000000110000000000000000001
10000000000000000ooo000cc0001
10000000000000000000000000001
11111111100000000110000000111111
111111111000000000110000000111111
        1001000000000000000000001
        1001000000000000000000001
111111111000000000000000000000001
100000000000000000000111111111111
11110000000000000000000000001
11110000000000000000000000001
11000000110000000000000000001
10000000000000000ooo000cc0001
10000000000000000000000000001
11111111100000000110000000111111
111111111000000000110000000111111
        1001000000000000000000001
        1001000000000000000000001
111111111000000000000000000000001
100000000000000000000111111111111
11110000000000000000000000001
11110000000000000000000000001
11000000110000000000000000001
10000000000000000ooo000cc0001
10000000000000000000000000001
11111111100000000110000000111111
111111111000000000110000000111111
        1001000000000000000000001
        1001000000000000000000001
111111111000000000000000000000001
100000000000000000000111111111111
11110000000000000000000000001
11110000000000000000000000001
11000000110000000000000000001
10000000000000000ooo000cc0001
10000000000000000000000000001
11111111100000000110000000111111
111111111000000000110000000111111
        1001000000000000000000001
        1001000000000000000000001
111111111000000000000000000000001
100000000000000000000111111111111
11110000000000000000000000001
11110000000000000000000000001
11000000110000000000000000001
10000000000000000ooo000cc0001
10000000000000000000000000001
11111111100000000110000000111111
111111111000000000110000000111111
        1001000000000000000000001
        1001000000000000000000001
111111111000000000000000000000001
100000000000000000000111111111111
11110000000000000000000000001
11110000000000000000000000001
11000000110000000000000000001
10000000000000000ooo000cc0001
10000000000000000000000000001
11111111100000000110000000111111
111111111000000000110000000111111
        1001000000000000000000001
        1001000000000000000000001
111111111000000000000000000000001
100000000000000000000111111111111
11110000000000000000000000001
11110000000000000000000000001
11000000110000000000000000001
10000000000000000ooo000cc0001
10000000000000000000000000001
11111111100000000110000000111111
111111111000000000110000000111111
        1001000000000000000000001
        1001000000000000000000001
111111111000000000000000000000001
100000000000000000000111111111111
11110000000000000000000000001
11110000000000000000000000001
11000000110000000000000000001
10000000000000000ooo000cc0001
10000000000000000000000000001
11111111100000000110000000111111
111111111000000000110000000111111
        1001000000000000000000001
        1001000000000000000000001
111111111000000000000000000000001
100000000000000000000111111111111
11110000000000000000000000001
11110000000000000000000000001
11000000110000000000000000001
10000000000000000ooo000cc0001
10000000000000000000000000001
11111111100000000110000000111111
111111111000000000110000000111111
        1001000000000000000000001
        1001000000000000000000001
111111111000000000000000000000001
100000000000000000000111111111111
11110000000000000000000000001
11110000000000000000000000001
11000000110000000000000000001
10000000000000000ooo000cc0001
10000000000000000000000000001
11111111100000000110000000111111
111111111000000000110000000111111
        1001000000000000000000001
        1001000000000000000000001
111111111000000000000000000000001
100000000000000000000111111111111
11110000000000000000000000001
11110000000000000000000000001
11000000110000000000000000001
10000000000000000ooo000cc0001
10000000000000000000000000001
11111111100000000110000000111111
111111111000000000110000000111111
        1001000000000000000000001
        1001000000000000000000001
111111111000000000000000000000001
100000000000000000000111111111111
11110000000000000000000000001
11110000000000000000000000001
11000000110000000000000000001
10000000000000000ooo000cc0001
10000000000000000000000000001
11111111100000000110000000111111
111111111000000000110000000111111
        1001000000000000000000001
        1001000000000000000000001
111111111000000000000000000000001
100000000000000000000111111111111
11110000000000000000000000001
11110000000000000000000000001
11000000110000000000000000001
10000000000000000ooo000cc0001
10000000000000000000000000001
11111111100000000110000000111111
111111111000000000110000000111111
        1001000000000000000000001
        1001000000000000000000001
111111111000000000000000000000001
100000000000000000000111111111111
11110000000000000000000000001
11110000000000000000000000001
11000000110000000000000000001
10000000000000000ooo000cc0001
10000000000000000000000000001
11111111100000000110000000111111
111111111000000000110000000111111
        1001000000000000000000001
        1001000000000000000000001
111111111000000000000000000000001
100000000000000000000111111111111
11110000000000000000000000001
11110000000000000000000000001
11000000110000000000000000001
10000000000000000ooo000cc0001
10000000000000000000000000001
11111111100000000110000000111111
111111111000000000110000000111111
        1001000000000000000000001
        1001000000000000000000001
111111111000000000000000000000001
100000000000000000000111111111111
11110000000000000000000000001
11110000000000000000000000001
11000000110000000000000000001
10000000000000000ooo000cc0001
10000000000000000000000000001
11111111100000000110000000111111
111111111000000000110000000111111
        1001000000000000000000001
        1001000000000000000000001
111111111000000000000000000000001
100000000000000000000111111111111
11110000000000000000000000001
11110000000000000000000000001
11000000110000000000000000001
10000000000000000ooo000cc0001
10000000000000000000000000001
11111111100000000110000000111111
111111111000000000110000000111111
        1001000000000000000000001
        1001000000000000000000001
111111111000000000000000000000001
100000000000000000000111111111111
11110000000000000000000000001
11110000000000000000000000001
11000000110000000000000000001
10000000000000000ooo000cc0001
10000000000000000000000000001
11111111100000000110000000111111
111111111000000000110000000111111
        1001000000000000000000001
        1001000000000000000000001
111111111000000000000000000000001
100000000000000000000111111111111
11110000000000000000000000001
11110000000000000000000000001
11000000110000000000000000001
10000000000000000ooo000cc0001
10000000000000000000000000001
11111111100000000110000000111111
111111111000000000110000000111111
        1001000000000000000000001
        1001000000000000000000001
111111111000000000000000000000001
100000000000000000000111111111111
11110000000000000000000000001
11110000000000000000000000001
11000000110000000000000000001
10000000000000000ooo000cc0001
10000000000000000000000000001
11111111100000000110000000111111
111111111000000000110000000111111
        1001000000000000000000001
        1001000000000000000000001
111111111000000000000000000000001
100000000000000000000111111111111
11110000000000000000000000001
11110000000000000000000000001
11000000110000000000000000001
10000000000000000ooo000cc0001
10000000000000000000000000001
11111111100000000110000000111111
111111111000000000110000000111111
        1001000000000000000000001
        1001000000000000000000001
111111111000000000000000000000001
100000000000000000000111111111111
11110000000000000000000000001
11110000000000000000000000001
11000000110000000000000000001
10000000000000000ooo000cc0001
10000000000000000000000000001
11111111100000000110000000111111
111111111000000000110000000111111
        1001000000000000000000001
        1001000000000000000000001
111111111000000000000000000000001
100000000000000000000111111111111
11110000000000000000000000001
11110000000000000000000000001
11000000110000000000000000001
10000000000000000ooo000cc0001
10000000000000000000000000001
11111111100000000110000000111111
111111111000000000110000000111111
        1001000000000000000000001
        1001000000000000000000001
111111111000000000000000000000001
100000000000000000000111111111111
11110000000000000000000000001
11110000000000000000000000001
11000000110000000000000000001
10000000000000000ooo000cc0001
10000000000000000000000000001
11111111100000000110000000111111
111111111000000000110000000111111
        1001000000000000000000001
        1001000000000000000000001
111111111000000000000000000000001
100000000000000000000111111111111
11110000000000000000000000001
11110000000000000000000000001
11000000110000000000000000001
10000000000000000ooo000cc0001
10000000000000000000000000001
11111111100000000110000000111111
111111111000000000110000000111111
        1001000000000000000000001
        1001000000000000000000001
111111111000000000000000000000001
100000000000000000000111111111111
11110000000000000000000000001
11110000000000000000000000001
11000000110000000000000000001
10000000000000000ooo000cc0001
10000000000000000000000000001
11111111100000000110000000111111
111111111000000000110000000111111
        1001000000000000000000001
        1001000000000000000000001
111111111000000000000000000000001
100000000000000000000111111111111
11110000000000000000000000001
11110000000000000000000000001
11000000110000000000000000001
10000000000000000ooo000cc0001
10000000000000000000000000001
11111111100000000110000000111111
111111111000000000110000000111111
        1001000000000000000000001
        1001000000000000000000001
111111111000000000000000000000001
100000000000000000000111111111111
11110000000000000000000000001
11110000000000000000000000001
11000000110000000000000000001
10000000000000000ooo000cc0001
10000000000000000000000000001
11111111100000000110000000111111
111111111000000000110000000111111
        1001000000000000000000001
        1001000000000000000000001
111111111000000000000000000000001
100000000000000000000111111111111
11110000000000000000000000001
11110000000000000000000000001
11000000110000000000000000001
10000000000000000ooo000cc0001
10000000000000000000000000001
11111111100000000110000000111111
111111111000000000110000000111111
        1001000000000000000000001
        1001000000000000000000001
111111111000000000000000000000001
100000000000000000000111111111111
11110000000000000000000000001
11110000000000000000000000001
11000000110000000000000000001
10000000000000000ooo000cc0001
10000000000000000000000000001
11111111100000000110000000111111
111111111000000000110000000111111
        1001000000000000000000001
        1001000000000000000000001
111111111000000000000000000000001
100000000000000000000111111111111
11110000000000000000000000001
11110000000000000000000000001
11000000110000000000000000001
10000000000000000ooo000cc0001
10000000000000000000000000001
11111111100000000110000000111111
111111111000000000110000000111111
        1001000000000000000000001
        1001000000000000000000001
111111111000000000000000000000001
100000000000000000000111111111111
11110000000000000000000000001
11110000000000000000000000001
11000000110000000000000000001
10000000000000000ooo000cc0001
10000000000000000000000000001
11111111100000000110000000111111
111111111000000000110000000111111
        1001000000000000000000001
        1001000000000000000000001
111111111000000000000000000000001
100000000000000000000111111111111
11110000000000000000000000001
11110000000000000000000000001
11000000110000000000000000001
10000000000000000ooo000cc0001
10000000000000000000000000001
11111111100000000110000000111111
111111111000000000110000000111111
        1001000000000000000000001
        1001000000000000000000001
111111111000000000000000000000001
100000000000000000000111111111111
11110000000000000000000000001
11110000000000000000000000001
11000000110000000000000000001
10000000000000000ooo000cc0001
10000000000000000000000000001
11111111100000000110000000111111
111111111000000000110000000111111
        1001000000000000000000001
        1001000000000000000000001
111111111000000000000000000000001
100000000000000000000111111111111
11110000000000000000000000001
11110000000000000000000000001
11000000110000000000000000001
10000000000000000ooo000cc0001
10000000000000000000000000001
11111111100000000110000000111111
111111111000000000110000000111111
        1001000000000000000000001
        1001000000000000000000001
111111111000000000000000000000001
100000000000000000000111111111111
11110000000000000000000000001
11110000000000000000000000001
11000000110000000000000000001
10000000000000000ooo000cc0001
10000000000000000000000000001
11111111100000000110000000111111
111111111000000000110000000111111
        1001000000000000000000001
        1001000000000000000000001
111111111000000000000000000000001
100000000000000000000111111111111
11110000000000000000000000001
11110000000000000000000000001
11000000110000000000000000001
10000000000000000ooo000cc0001
10000000000000000000000000001
11111111100000000110000000111111
111111111000000000110000000111111
        1001000000000000000000001
        1001000000000000000000001
111111111000000000000000000000001
100000000000000000000111111111111
11110000000000000000000000001
11110000000000000000000000001
11000000110000000000000000001
10000000000000000ooo000cc0001
10000000000000000000000000001
11111111100000000110000000111111
111111111000000000110000000111111
        1001000000000000000000001
        1001000000000000000000001
111111111000000000000000000000001
100000000000000000000111111111111
11110000000000000000000000001
11110000000000000000000000001
11000000110000000000000000001
10000000000000000ooo000cc0001
10000000000000000000000000001
11111111100000000110000000111111
111111111000000000110000000111111
        1001000000000000000000001
        1001000000000000000000001
111111111000000000000000000000001
100000000000000000000111111111111
11110000000000000000000000001
11110000000000000000000000001
11000000110000000000000000001
10000000000000000ooo000cc0001
10000000000000000000000000001
11111111100000000110000000111111
111111111000000000110000000111111
        1001000000000000000000001
        1001000000000000000000001
111111111000000000000000000000001
100000000000000000000111111111111
11110000000000000000000000001
11110000000000000000000000001
11000000110000000000000000001
10000000000000000ooo000cc0001
10000000000000000000000000001
11111111100000000110000000111111
111111111000000000110000000111111
        1001000000000000000000001
        1001000000000000000000001
111111111000000000000000000000001
100000000000000000000111111111111
11110000000000000000000000001
11110000000000000000000000001
11000000110000000000000000001
10000000000000000ooo000cc0001
10000000000000000000000000001
11111111100000000110000000111111
111111111000000000110000000111111
        1001000000000000000000001
        1001000000000000000000001
111111111000000000000000000000001
100000000000000000000111111111111
11110000000000000000000000001
11110000000000000000000000001
11000000110000000000000000001
10000000000000000ooo000cc0001
10000000000000000000000000001
11111111100000000110000000111111
111111111000000000110000000111111
        1001000000000000000000001
        1001000000000000000000001
111111111000000000000000000000001
100000000000000000000111111111111
11110000000000000000000000001
11110000000000000000000000001
11000000110000000000000000001
10000000000000000ooo000cc0001
10000000000000000000000000001
11111111100000000110000000111111
111111111000000000110000000111111
        1001000000000000000000001
        1001000000000000000000001
111111111000000000000000000000001
100000000000000000000111111111111
11110000000000000000000000001
11110000000000000000000000001
11000000110000000000000000001
10000000000000000ooo000cc0001
10000000000000000000000000001
11111111100000000110000000111111
111111111000000000110000000111111
        1001000000000000000000001
        1001000000000000000000001
111111111000000000000000000000001
100000000000000000000111111111111
11110000000000000000000000001
11110000000000000000000000001
11000000110000000000000000001
10000000000000000ooo000cc0001
10000000000000000000000000001
11111111100000000110000000111111
111111111000000000110000000111111
        1001000000000000000000001
        1001000000000000000000001
111111111000000000000000000000001
100000000000000000000111111111111
11110000000000000000000000001
11110000000000000000000000001
11000000110000000000000000001
10000000000000000ooo000cc0001
10000000000000000000000000001
11111111100000000110000000111111
111111111000000000110000000111111
        1001000000000000000000001
        1001000000000000000000001
111111111000000000000000000000001
100000000000000000000111111111111
11110000000000000000000000001
11110000000000000000000000001
11000000110000000000000000001
10000000000000000ooo000cc0001
10000000000000000000000000001
11111111100000000110000000111111
111111111000000000110000000111111
        1001000000000000000000001
        1001000000000000000000001
111111111000000000000000000000001
100000000000000000000111111111111
11110000000000000000000000001
11110000000000000000000000001
11000000110000000000000000001
10000000000000000ooo000cc0001
10000000000000000000000000001
11111111100000000110000000111111
111111111000000000110000000111111
        1001000000000000000000001
        1001000000000000000000001
111111111000000000000000000000001
100000000000000000000111111111111
11110000000000000000000000001
11110000000000000000000000001
11000000110000000000000000001
10000000000000000ooo000cc0001
10000000000000000000000000001
11111111100000000110000000111111
111111111000000000110000000111111
        1001000000000000000000001
        1001000000000000000000001
111111111000000000000000000000001
100000000000000000000111111111111
11110000000000000000000000001
11110000000000000000000000001
11000000110000000000000000001
10000000000000000ooo000cc0001
10000000000000000000000000001
11111111100000000110000000111111
111111111000000000110000000111111
        1001000000000000000000001
        1001000000000000000000001
111111111000000000000000000000001
100000000000000000000111111111111
11110000000000000000000000001
11110000000000000000000000001
11000000110000000000000000001
10000000000000000ooo000cc0001
10000000000000000000000000001
11111111100000000110000000111111
111111111000000000110000000111111
        1001000000000000000000001
        1001000000000000000000001
111111111000000000000000000000001
100000000000000000000111111111111
11110000000000000000000000001
11110000000000000000000000001
11000000110000000000000000001
10000000000000000ooo000cc0001
10000000000000000000000000001
11111111100000000110000000111111
111111111000000000110000000111111
        1001000000000000000000001
        1001000000000000000000001
111111111000000000000000000000001
100000000000000000000111111111111
11110000000000000000000000001
11110000000000000000000000001
11000000110000000000000000001
10000000000000000ooo000cc0001
10000000000000000000000000001
11111111100000000110000000111111
111111111000000000110000000111111
        1001000000000000000000001
        1001000000000000000000001
111111111000000000000000000000001
100000000000000000000111111111111
11110000000000000000000000001
11110000000000000000000000001
11000000110000000000000000001
10000000000000000ooo000cc0001
10000000000000000000000000001
11111111100000000110000000111111
111111111000000000110000000111111
        1001000000000000000000001
        1001000000000000000000001
111111111000000000000000000000001
100000000000000000000111111111111
11110000000000000000000000001
11110000000000000000000000001
11000000110000000000000000001
10000000000000000ooo000cc0001
10000000000000000000000000001
11111111100000000110000000111111
111111111000000000110000000111111
        1001000000000000000000001
        1001000000000000000000001
111111111000000000000000000000001
100000000000000000000111111111111
11110000000000000000000000001
11110000000000000000000000001
11000000110000000000000000001
10000000000000000ooo000cc0001
10000000000000000000000000001
11111111100000000110000000111111
111111111000000000110000000111111
        1001000000000000000000001
        1001000000000000000000001
111111111000000000000000000000001
100000000000000000000111111111111
11110000000000000000000000001
11110000000000000000000000001
11000000110000000000000000001
10000000000000000ooo000cc0001
10000000000000000000000000001
11111111100000000110000000111111
111111111000000000110000000111111
        1001000000000000000000001
        1001000000000000000000001
111111111000000000000000000000001
100000000000000000000111111111111
11110000000000000000000000001
11110000000000000000000000001
11000000110000000000000000001
10000000000000000ooo000cc0001
10000000000000000000000000001
11111111100000000110000000111111
111111111000000000110000000111111
        1001000000000000000000001
        1001000000000000000000001
111111111000000000000000000000001
100000000000000000000111111111111
11110000000000000000000000001
11110000000000000000000000001
11000000110000000000000000001
10000000000000000ooo000cc0001
11111111111111111111111111111111