NO ./assets/Tile_10_64x64.xpm
SO ./assets/Tile_12_64x64.xpm
WE ./assets/Tile_61_64x64.xpm
EA ./assets/wall_64x64.xpm

F 255,255,255
C 0,00,0

1111111111
1000001001
1010000001
1000000001
1000N00001
1000010001
1000000001
1000000001
1111111111