NO ./assets/Tile_10_64x64.xpm
SO ./assets/Tile_12_64x64.xpm
WE ./assets/Tile_61_64x64.xpm
EA ./assets/wall_64x64.xpm

F 255,255,255
C 100,90,0

1111111111
1000001001
1010000001
1000000001
1001N10001
1000010001
1000000001
1000000001
1111111111