NO ./assets/brick-wall.xpm
SO ./assets/dungeon-light.xpm
WE ./assets/broken-wall.xpm
EA ./assets/stone-wall.xpm

F 125,78,38
C 40,40,40

11111111111111111111111111111111111111111111111111111111111
10001111111111111111111111111111111111111111111111111111111
10101111111111111111111111111111111111111111111111111111111
10001111111111111111111111111111111111111111111111111111111
10001111111111111111111111111111111111111111111111111111111
10001111111111111111111111111111111111111111111111111111111
10001111111111111111111111111111111111111111111111111111111
100N1111111111111111111111111111111111111111111111111111111
11111111111111111111111111111111111111111111111111111111111
