NO ./assets/brick-wall.xpm
SO ./assets/dungeon-light.xpm
WE ./assets/broken-wall.xpm
EA ./assets/stone-wall.xpm

F 125,78,38
C 40,40,40

1111111111
1000001001
1010000001
1000000001
1001E10001
1000010001
1000ooo001
1000000001
1111111111
1111111111
1000000001
1111111111