NO ./assets/brick-wall.xpm
SO ./assets/dungeon-light.xpm
WE ./assets/broken-wall.xpm
EA ./assets/stone-wall.xpm

F 125,78,38
C 40,40,40

        1111111111111111111111111
        1000000000110000000000001
        1000000000010000000000001
        1001000000000000000000001
111111111011000000000000000000001
100000000011000000000111111111111
11110000000000000000000000001
11110000000000000000000000001
11000000000000000000000000001
10000000000000000000000000001
1000e000000000000000000000001
11000001110101011111000000N0111
11110111 1110101 101111010001
11111111 1111111 111111111111