NO ./assets/Tile_10_64x64.xpm
SO ./assets/Tile_12_64x64.xpm
WE ./assets/Tile_61_64x64.xpm
EA ./assets/wall_64x64.xpm

F 110,100,100
C 105,20,100

1111111111
1000000001
1000E00001
1000000001
1000000001
1000000001
1000000001
1000000001
1111111111